{
  enemies: [
    {
      type: Dino
      x: 17
      y: 1
    }
    {
      type: Dino
      x: 20
      y: 1
    }
    {
      type: Dino
      x: 36
      y: 1
    }
    {
      type: Dino
      x: 49
      y: 1
    }
  ],
  collectables: [
    {
      "type": PowerUp
      "x": 21
      "y": 1
    }
  ],
  mapHeight: 8
  mapWidth: 50
  tileMap: [
    [ 0, 0, 0, 0, 0, 0, 0, 0, 0, 0, 0, 0, 0, 0, 0, 0, 0, 0, 0, 0, 0, 0, 0, 0, 0, 0, 0, 0, 0, 0, 0, 0, 0, 0, 0, 0, 0, 0, 0, 0, 0, 0, 0, 0, 0, 0, 0, 0, 0, 0 ]
    [ 0, 0, 0, 0, 0, 0, 0, 0, 0, 0, 0, 0, 0, 0, 0, 0, 0, 0, 0, 0, 0, 0, 0, 0, 0, 0, 0, 0, 0, 0, 0, 0, 0, 0, 0, 0, 0, 0, 0, 0, 0, 0, 0, 0, 0, 0, 0, 0, 0, 0 ]
    [ 0, 0, 0, 0, 0, 0, 0, 0, 0, 0, 0, 0, 0, 0, 0, 0, 0, 0, 0, 0, 13,15,0, 0, 0, 0, 0, 0, 0, 0, 0, 0, 0, 13,14,14,15,0, 0, 0, 0, 0, 0, 0, 0, 0, 0, 0, 0, 0 ]
    [ 0, 0, 0, 0, 0, 0, 0, 0, 0, 0, 0, 0, 0, 0, 0, 0, 0, 0, 0, 0, 0, 0, 0, 0, 0, 0, 0, 0, 0, 0, 0, 0, 0, 0, 0, 0, 0, 0, 13,14,15,0, 0, 0, 0, 0, 0, 0, 0, 0 ]
    [ 0, 0, 0, 0, 0, 0, 0, 0, 0, 0, 0, 1, 3, 0, 0, 0, 0, 0, 13,14,14,14,14,15,0, 0, 0, 0, 0, 13,14,15,0, 0, 0, 0, 0, 0, 0, 0, 0, 0, 0, 0, 0, 0, 0, 0, 0, 1 ]
    [ 0, 0, 0, 0, 0, 0, 0, 0, 0, 0, 1, 8, 10,3, 0, 0, 0, 0, 0, 0, 0, 0, 0, 0, 0, 0, 0, 0, 0, 0, 0, 0, 0, 0, 0, 0, 0, 0, 0, 0, 1, 2, 3, 0, 0, 0, 0, 0, 1, 8 ]
    [ 0, 0, 0, 0, 0, 0, 0, 0, 0, 1, 8, 5, 5, 10,3, 0, 0, 0, 0, 0, 0, 0, 0, 0, 0, 0, 1, 3, 17,17,17,17,17,17,17,17,17,17,17,17,4, 5,10,11, 2, 2, 2, 7, 8, 5 ]
    [ 2, 2, 2, 2, 2, 2, 2, 2, 7, 8, 5, 5, 5, 5, 10,11,2, 2, 2, 2, 2, 2, 2, 2, 2, 7, 8, 6, 18,18,18,18,18,18,18,18,18,18,18,18,4, 5, 5, 5, 5, 5, 5, 5, 5, 5 ]
  ]
}
